##########
#..#..#..#
#..#..#..#
#..#..#..#
#..#..#..#
#..#..#..#
#..#..#..#
#..#..#..#
####  ####
####  ####
####  ####
   #### .