##########
#..#..#..#
#..#..#..#
#..#..#..#
#..#..#..###
#..#..#..#
#..#..#..######
#..#..#..#
####  ####
####  ####
#####p####
   #### .