##########
#..#..#..#
#..#..#..#
#..#..#..#
#..#..#..#
#..#..#..#
#..#..#..#
#..#..#..#
####  ####
####  ####
#####p####
   #### .