###############
#..#..#.......#
#.....#..#....#
#..#..#..#....#
#..#..#..###..#
#..#.....#....#
#..#..#..######
#..#..#..#....#
#### .####....#
#### .........#
#####p####....#
########......#
###############