#######
#p....#
#..g..#
#....e#
#..e..#
#e...e#
#######