#######
#p....#
#.....#
#.....#
#.....#
#....e#
#######